1111111111111111111111
1E100000C010C0000000X1
1010011100100000101001
1011110010101010101001
1010000000000C00000001
10C001110C111000P00111
1101010011100001101001
10010000000000C01000C1
1111111111111111111111
